-50
54
-60
60
000000000000000000000000000000000000000000000000000000000000000000000000000000000000000000000000000000000
111111111111111111111111111111111111111111111111111111111111111111111111111111111111111111111111111111110
111111111111111111111111111111111111111111111111111111111111111111111111111111111111111111111111111111110
111111111111111111111111111111111111111111111111111111111111111111111111111111111111111111111111111111110
111111111111111111111111111111111111111111111111111111111111111111111111111111111111111111111111111111110
111111111111111111111111111111111111111111111111111111111111111111111111111111111111111111111111111111110
110000000000000000000000000000000000000000000000000000000000000000000000000000000000000000000000000000110
110000000000000000000000000000000000000000000000000000000000000000000000000000000000000000000000000000110
110000000000000000000000000000000000000000000000000000000000000000000000000000000000000000000000000000110
110000000000000000000000000000000000000000000000000000000000000000000000000000000000000000000000000000110
110000000000000000000000000000000000000000000000000000000000000000000000000000000000000000000000000000110
110000000000000000000000000000000000000000000000000000000000000000000000000000000000000000000000000000110
110000000000000000000000000000000000000000000000000000000000000000000000000000000000000000000000000000110
110000000000000000000000000000000000000000000000000000000000000000000000000000000000000000000000000000110
110000000000000000000000000000000000000000000000000000000000000000000000000000000000000000000000000000110
110000000000000000000000000000000000000000000000000000000000000000000000000000000000000000000000000000110
110000000000000000000000000000000000000000000000000000000000000000000000000000000000000000000000000000110
110000000000000000000000000000000000000000000000000000000000000000000000000000000000000000000000000000110
110000000000000000000000000000000000000000000000000000000000000000000000000000000000000000000000000000110
110000000000000000000000000000000000000000000000000000000000000000000000000000000000000000000000000000110
110000000000000000000000000000000000000000000000000000000000000000000000000000000000000000000000000000110
110000000000000000000000000000000000000000000000000000000000000000000000000000000000000000000000000000110
110000000000000000000000000000000000000000000000000000000000000000000000000000000000000000000000000000110
110000000000000000000000000000000000000000000000000000000000000000000000000000000000000000000000000000110
110000000000000000000000000000000000000000000000000000000000000000000000000000000000000000000000000000110
110000000000000000000000000000000000000000000000000000000000000000000000000000000000000000000000000000110
110000000000000000000000000000000000000000000000000000000000000000000000000000000000000000000000000000110
110000000000000000000000000000000000000000000000000000000000000000000000000000000000000000000000000000110
110000000000000000000000000000000000000000000000000000000000000000000000000000000000000000000000000000110
110000000000000000000000000000000000000000000000000000000000000000000000000000000000000000000000000000110
110000000000000000000000000000000000000000000000000000000000000000000000000000000000000000000000000000110
110000000000000000000000000000000000000000000000000000000000000000000000000000000000000000000000000000110
110000000000000000000000000000000000000000000000000000000000000000000000000000000000000000000000000000110
110000000000000000000000000000000000000000000000000000000000000000000000000000000000000000000000000000110
110000000000000000000000000000000000000000000000000000000000000000000000000000000000000000000000000000110
110000000000000000000000000000000000000000000000000000000000000000000000000000000000000000000000000000110
110000000000000000000000000000000000000000000000000000000000000000000000000000000000000000000000000000110
110000000000000000000000000000000000000000000000000000000000000000000000000000000000000000000000000000110
110000000000000000000000000000000000000000000000000000000000000000000000000000000000000000000000000000110
110000000000000000000000000000000000000000000000000000000000000000000000000000000000000000000000000000110
110000000000000000000000000000000000000000000000000000000000000000000000000000000000000000000000000000110
110000000000000000000000000000000000000000000000000000000000000000000000000000000000000000000000000000110
110000000000000000000000000000000000000000000000000000000000000000000000000000000000000000000000000000110
110000000000000000000000000000000000000000000000000000000000000000000000000000000000000000000000000000110
110000000000000000000000000000000000000000000000000000000000000000000000000000000000000000000000000000110
110000000000000000000000000000000000000000000000000000000000000000000000000000000000000000000000000000110
110000000000000000000000000000000000000000000000000000000000000000000000000000000000000000000000000000110
110000000000000000000000000000000000000000000000000000000000000000000000000000000110000000000000000000110
110000000000000000000000000000000000000000000000000000000000000000000000000000011110000000000000000000110
110000000000000000000000001100000000000000000000000000000000000000000000000000011000000000000000000000110
110000000000000000000000001100000000000000000000000000000000000000000000000000000000000000000000000000110
110000000000000000000000000000000000000000000000000000000000000000000000000000000000000001100000000000110
110000000000000000000001000000100000000000000000000000000000000000000000000000000000000001100000000000110
110000000000000000000001000000100000000000000000000000000000000000000000000000000000000000000000000000110
110000000000000000000000000000000000000000000000010000100000000000000000000000000000000000000000000000110
110000000000000000000000000000000000000000000000010000100000000000000000000000000000000000000000000000110
110000000000000000000000000000000000000000000000000000000000000000000000000000000000000000000000000000110
110000000000000000000000000000000000000000000010000000000100000000000000000000000000000000000000000000110
110000000000000000000000000000000000000000000010000000000100000000000000000000000000000000000000000000110
110000000000000000000000000000000000000000001000000000000001000000000000000000000000000000000000000000110
110000000000000000000000000000000000000000001000000000000001000000000000000000000000000000000000000000110
110000000000000000000000000000000000000000000000000000000000000000000000000000000000000000000000000000110
110000000000000000000000000000000000000000000000000000000000000000000000000000000000000000000000000000110
110000000000000000000000000000000000000000000000000000000000000000000000000000000000000000000000000000110
110000000000000000000000000000000000000000000000000000000000000000000000000000000000000000000000000000110
110000000000000000000000000000000000000000000010000000000100000000000000000000000000000000000000000000110
110000000000000000000000000000000000000000000010000000000100000000000000000000000000000000000000000000110
110000000000000000000000000000000000000000000000000000000000000000000000000000000000000000000000000000110
110000000000000000000000000000000000000000000000000000000000000000000000000000000000000000000000000000110
110000000000000000000000000000000000000000000000000000000000000000000000000001101000000000000000000000110
110000000000000000000000000000000000000000000000000000000000000000000000000001101000000000000000000000110
110000000000000000000000000000000000000000000010000000000100000000000000000000000000000000000000000000110
110000000000000000000000000000000000000000000010000000000100000000000000000000000000000000000000000000110
110000000000000000000000000000000000000000000000000000000000000000000000000000000000000000000000000000110
110000000000000000000000011000000000000000000000000000000000000000000000000000000000000000000000000000110
110000000000000000000000011110000000000000000000111111110000000000000000000000000000000000000000000000110
110000000000000000000000000110000000000000000000111111110000000000000000000000000000000000000000000000110
110000000000000000000000000000000000000000000000111111110000000000000000000000000000000000000000000000110
110000000000000000000000000000000000000000000000111111110000000000000000000000000000000000000000000000110
110000000000000000000000000000000000000000000000000000000000000000000000000000000000000000000000000000110
110000000000000000000000000000000000000000000000000000000000000000000000000000000000000000000000000000110
110000000000000000000000000000000000000000000000000000000000000000000000000000000000000000000000000000110
110000000000000000000000000000000000000000000000000000000000000000000000000000000000000000000000000000110
110000000000000000000000000000000000000000000000000000000000000000000000000000000000000000000000000000110
110000000000000000000000000000000000000000000000000000000000000000000000000000000000000000000000000000110
110000000000000000000000000000000000000000000000000000000000000000000000000000000000000000000000000000110
110000000000000000000000000000000000000000000000000000000000000000000000000000000000000000000000000000110
110000000000000000000000000000000000000000000000000000000000000000000000000000000000000000000000000000110
110000000000000000000000000000000000000000000000000000000000000000000000000000000000000000000000000000110
110000000000000000000000000000000000000000000000000000000000000000000000000000000000000000000000000000110
110000000000000000000000000000000000000000000000000000000000000000000000000000000000000000000000000000110
110000000000000000000000000000000000000000000000000000000000000000000000000000000000000000000000000000110
110000000000000000000000000000000000000000000000000000000000000000000000000000000000000000000000000000110
110000000000000000000000000000000000000000000000000000000000000000000000000001111100000000000000000000110
110000000000000000000000000000000000000000000000000000000000000000000000000011111110000000000000000000110
110000000000000000000000000000000000000000000000000000000000000000000000000011111110000000000000000000110
110000000000000000000000000000000000000000000000000000000000000000000000000011111110000000000000000000110
110000000000000000000000000000000000000000000000000000000000000000000000000011111110000000000000000000110
110000000000000000000000000000000000000000000000000000000000000000000000000011111110000000000000000000110
110000000000000000000000000000000000000000000000000000000000000000000000000011111110000000000000000000110
110000000000000000000000000000000000000000000000000000000000000000000000000011111110000000000000000000110
110000000000000000000000000000000000000000000000000000000000000000000000000011111110000000000000000000110
110000000000000000000000000000000000000000000000000000000000000000000000000011111110000000000000000000110
110000000001110000000000000000000000000000000000000000000000000000000000000011111110000000000000000000110
110000000001110000000000000000000000000000000000000000000000000000000000000011111110000000000000000000110
110000000000000000000000000000000000000000000000000000000000000000000000000011111110000000000000000000110
110000000000000011000000000000000000000000000000000000000000000000000000000011111110000000000000000000110
110000000000000011000000000000000000000000000000000000000000000000000000000011111110000000000000000000110
110000000000000000000000000000000000000000000000000000000000000000000000000011111110000000000000000000110
110000000000000000000000000000000000000000000000000000000000000000000000000011111110000000000000000000110
110000000000000000000000000000000000000000000000000000000000000000000000000000000000000000000000000000110
110000000000000000000000000000000000000000000000000000000000000000000000000000000000000000000000000000110
110000000000000000000000000000000000000000000000000000000000000000000000000000000000000000000000000000110
110000000000000000000000000000000000000000000000000000000000000000000000000000000000000000000000000000110
110000000000000000000000000000000000000000000000000000000000000000000000000000000000000000000000000000110
110000000000000000000000000000000000000000000000000000000000000000000000000000000000000000000000000000110
110000000000000000000000000000000000000000000000000000000000000000000000000000000000000000000000000000110
110000000000000000000000000000000000000000000000000000000000000000000000000000000000000000000000000000110
110000000000000000000000000000000000000000000000000000000000000000000000000000000000000000000000000000110
110000000000000000000000000000000000000000000000000000000000000000000000000000000000000000000000000000110
111111111111111111111111111111111111111111111111111111111111111111111111111111111111111111111111111111110
